"6_3_2_11.TXT" (2559 bytes) was created on 07-08-92

ASTRONAUT BIRTHPLACES BY STATE
SOURCE:  Information Summaries
Astronaut Fact Book
February, 1992


ALABAMA:  Hartsfield, Jemison, K. Thornton, James Voss, C. Williams
ARKANSAS:  Covey                        

CALIFORNIA:  Chilton, Clifford, Coats, Hauck, McCulley, Ochoa, O'Connor, Ride,
van Hoften, Young
COLORADO:  Brand, Carpenter, Carr, Lounge, Roosa, Swigert
CONNECTICUT:  Spring, Thuot

DELAWARE:  Sherlock
DISTRICT OF COLUMBIA:  Gregory, Stewart

FLORIDA:  Davis, Lenoir, Richards, Thagard

GEORGIA:  Bridges, Carter, Hammond, Walker

HAWAII:  Onizuka

ILLINOIS:  Cernan, Kerwin, Mattingly, McDivitt, Meade, Nagel, Veach
INDIANA:  J. Allen, Borman, M. Brown, England, Grissom, Janice Voss, D.
Williams, Wolf             
IOWA:  Cunningham, Hilmers, Nelson, Shriver

KANSAS:  Engle, Evans, Hawley
KENTUCKY:  Wilcutt

LOUISIANA:  Halsell

MARYLAND:  Ivins, Jones, Reightler
MASSACHUSETTS:  Apt, Duffy, McCandless, Musgrave, O'Leary, Precourt
MICHIGAN:  Chaffee, Leestma, Lousma, McMonagle, Searfoss, Shaw, Worden
MINNESOTA:  Cabana, D. Gardner
MISSISSIPPI:  Haise, Peterson, Truly
MISSOURI:  Akers, Godwin, Springer

NEW HAMPSHIRE:  Shepard
NEW JERSEY:  Aldrin, Schirra, Schweickart, Sullivan
NEW MEXICO:  Gutierrez, Schmitt
NEW YORK:  Adamson, Bobko, Cleave, E. Collins, A. Fisher, Fullerton, E. Gibson,
R. Gibson, Grabe, W. Gregory, Hoffman, Melnick, Parker, Runco, Wetherbee
NORTH CAROLINA:  E. Baker, C. Brown, Duke, Helms, McArthur, Smith, W. Thornton
NORTH DAKOTA:  Buchli, Hieb
OHIO:  Armstrong, Bassett, Cameron, Eisele, Glenn, Harbaugh, Henize, Henricks,
Lovell, Low, Overmyer, Resnik, Sega, Thomas, Walz
OKLAHOMA:  Cooper, Garriott, Pogue, Stafford
OREGON:  Griggs
PENNSYLVANIA:  A. Allen, Bagian, Bluford, Bursch, Conrad, Freeman, Hart, Irwin,
Weitz
RHODE ISLAND:  Readdy
SOUTH CAROLINA:  Bolden, Casper, Culbertson, McNair
SOUTH DAKOTA:  Gemar
TENNESSEE:  M. Baker, Bull, Jernigan, Seddon, Shepherd
TEXAS:  Bean, Blaha, Cockrell, Creighton, Crippen, Fabian, W. Fisher, Givens,
Harris, Holmquest, Mitchell, Mullane, Scott, See, White
UTAH:  Lind
VERMONT:  Graveline
VIRGINIA:  Bowersox, G. Gardner, Wisoff
WASHINGTON:  Dunbar, Gordon, Oswald, Scobee
WEST VIRGINIA:  McBride
WISCONSIN:  Brandenstein, Chiao, Lee, Michel, Slayton



ASTRONAUTS BORN IN OTHER COUNTRIES*


AUSTRALIA:        Chapman
CHINA:            Lucid
COSTA RICA:       Chang-Diaz
ENGLAND:          Foale
HONG KONG:        Anders
ITALY:            M. Collins
PACIFIC ISLANDS:  Newman
WALES:            Llewellyn
WEST GERMANY:     Thorne

*See biographical sketches for city.


